AFYC_마이그_0425	
BESTROOKIE_MIG	
BESTROOKIE_MIG_0512	
CP_AFYC_SUM	
CP_CAL_TEMP	
CP_CAL_TEST	
EXCHANGE_RATE_MIG	
FACEAMT_MIG	가입금액 마이그
LOWEST_PERFORM_EXCEPT_CONTRACT	
LTI_202212	[계약] 푸르덴셜 특약 마감 과거건(202212)
LTI_202302	[계약] 푸르덴셜 특약 마감 과거건(202302)
RANDOM_KEY_TEMP	랜덤 키 생성시 사용되는 문자열 집합
RIDER_납면	
RIDER_부활건	
RIDER_부활건_정보계	
SIGN_FILE_MGT	서명파일관리
SU_FC_JIGUB_PROCESS_MONTH	[SU][지급] 지급수수료 증권번호별
TBAPI_PCCPLUS_CUSTOMER_LOG	금소법 고객 매칭 로그
TBAP_PCCPLUS_CONTRACT	[API][PCCPLUS] PCCPLUS 계약
TBAP_PCCPLUS_CONTRACT_230830_BAK	
TBAP_PCCPLUS_FILE_INFO	[API][PCCPLUS] PCCPLUS 첨부파일정보
TBAP_PCCPLUS_FILE_INFO_2022_11_21	
TBAP_PCCPLUS_FILE_INFO_230711	[API][PCCPLUS] PCCPLUS 첨부파일정보_백업
TBBD_AUTH_SET	[BD][게시판] 게시판권한설정
TBBD_BOARD	[BD][게시판] 게시판
TBBD_BOARD_CONFIG	[BD][게시판] 게시판 설정
TBBD_COMMENT	[BD][게시판] 덧글
TBBD_FAQ_AUTH_SET	[BD][게시판] FAQ 게시판권한설정
TBBD_FAQ_BOARD	[BD][게시판] FAQ 게시판
TBBD_FAQ_COMMENT	[BD][게시판] FAQ 덧글
TBBD_FAQ_ITEM	[BD][게시판] FAQ 게시글
TBBD_FAQ_READ_USER	[BD][게시판] FAQ 게시글 열람기록
TBBD_ITEM	[BD][게시판] 게시글
TBBD_ITEM_VIEW_TARGET	[BD][게시판] 게시판 게시글 조회 대상
TBBD_QNA_AUTH_SET	[BD][게시판] QNA 게시판권한설정
TBBD_QNA_BOARD	[BD][게시판] QNA 게시판
TBBD_QNA_COMMENT	[BD][게시판] QNA 덧글
TBBD_QNA_ITEM	[BD][게시판] QNA 게시글
TBBD_QNA_READ_USER	[BD][게시판] QNA 게시글 열람기록
TBBD_READ_USER	[BD][게시판] 게시글 열람기록
TBBD_STANDARDS	[BD][게시판] 업무표준 게시판
TBBD_STANDARDS_AUTH_SET	[BD][게시판] 업무표준게시판권한설정
TBBD_STANDARDS_COMMENT	[BD][게시판] 업무표준 게시글 덧글
TBBD_STANDARDS_CONFIG	[BD][게시판] 업무표준 게시판 설정
TBBD_STANDARDS_ITEM	[BD][게시판] 업무표준 게시글
TBBS_COUNSEL	[DB][DB분배] DB분배 상담관리
TBBS_COUNSEL_HIST	[DB][DB분배] DB분배 상담이력 관리
TBBS_DBATTRIBUTE_MST	[BS][영업] DB 속성 관리
TBBS_DBDISTRIBUTION	[DB][DB분배] DB분배
TBBS_DBDISTRIBUTION_CONTRACT	[DB][DB분배] DB분배 고객 보유계약보험
TBBS_DBDISTRIBUTION_CONTRACT_DETAIL	[DB][DB분배] DB분배 고객 보유계약보험 보장내역
TBBS_DBDISTRIBUTION_INSURANCE	[DB][DB분배] DB분배 고객 추천보험
TBBS_DBDISTRIBUTION_INSURANCE_DETAIL	[DB][DB분배] DB분배 고객 추천보험 보장내역
TBBS_DBDISTRIBUTION_STATUS	[DB][DB분배] DB분배 상태 관리
TBBS_DBDISTRIBUTION_TARGET	[DB][DB분배] DB분배 대상자 관리
TBBS_DBDISTRIBUTION_UPLOAD_TMP	[DB][DB분배] DB분배 업로드 TMP 테이블
TBBS_EMPSMS	[SMS][문자전송] 발신번호 관리
TBBS_PTC_ATMT_MNG	PTC 달성관리
TBBS_PTC_ATMT_STND	PTC 달성기준
TBBS_PTC_CONTRACT_MONTH	
TBBS_PTC_CONTRACT_MONTH_230615	
TBBS_PTC_CONTRACT_MONTH_230705	
TBBS_PTC_CONTRACT_MONTH_BK	
TBBS_PTC_EXCLUDE_LP	[PM] PTC 제외자 관리
TBBS_PTC_HEAD_PRFRM_MONTH	PTC-SM/AM
TBBS_PTC_LP_EXCEPTION_STND_NAFYC	PTC LP 예외자 기준 NAFYC
TBBS_PTC_LP_HEAD_NAFYC_MONTH	계약당시 LP-조직장 PTC NAFYC
TBBS_PTC_LP_PRFRM_MONTH	PTC-LP
TBBS_PTC_LP_PRFRM_MONTH_BK	
TBBS_PTC_LP_PRFRM_SMAM_MONTH	PTC-LP
TBBS_PTC_LP_STOP_CNT	PTC LP 영업중지
TBBS_PTC_REAL_ANN_MONTH	월별 PTC 실제연인수
TBBS_STANDARDS_READ_USER	[BD][게시판] 업무표준 게시글 열람기록
TBCM_BUSINESS_DATE	[CM][공통] 영업일관리
TBCM_BUSINESS_LTI_DATE	[CM][프로모션] 영업일관리(LTI)
TBCM_COMMON_CODE	[CM][공통] 공통코드
TBCM_COMMON_CODE_GROUP	[CM][공통] 그룹공통코드
TBCM_COMMON_PRIZE	시상금관리
TBCM_HOLIDAY	[CM][공통] 공휴일관리
TBCM_INSCO	[CM][공통] 보험사
TBCN_ACTUAL_SUGUM_METHOD_CONF	[CN][계약] 실입금경로(실제수금방법) 관리
TBCN_ADDITIONAL_CONTRACT	
TBCN_ADDITIONAL_CONTRACT_BACKUP_230724	
TBCN_AGREE	
TBCN_BENEFICIARY	수익자정보
TBCN_BYENHWAN_RATE	[CN][계약] 변환율관리
TBCN_CASE_AGCS_USI_RATE_MONTH	[계약] 건별 AGCS 유지율
TBCN_CASE_SMAM_AGCS_USI_RATE_MONTH	[POK] 푸르덴셜 건별 SM/AM AGCS 유지 자료
TBCN_COLLECT_CONTRACT	[CN][계약] 수금 계약 리스트
TBCN_COLLECT_CONTRACT_CONF	[CN][계약] 수금 계약 상태 관리
TBCN_COLLECT_CONTRACT_PRUDENTAIL	푸르덴셜 보험료입금 테이블(계약)
TBCN_COLLECT_CONTRACT_TMP	[CN][계약] 수금 계약 리스트 업로드 이력
TBCN_COLLECT_METHOD_CONF	[CN][계약] 수금방법 관리
TBCN_CONSULTATION	
TBCN_CONSULTATION_ADDCONT_MAP	[CN][계약] 고객상담활동현황 추가청약 맵핑
TBCN_CONSULTATION_ADDINTRO_MAP	
TBCN_CONTRACT	[CN][계약] 계약관리
TBCN_CONTRACT_0217	
TBCN_CONTRACT_0701	
TBCN_CONTRACT_20230531	
TBCN_CONTRACT_20230816	
TBCN_CONTRACT_AFYC_MIG_202304	AFYC 04 마이그
TBCN_CONTRACT_BK_04	
TBCN_CONTRACT_BK_20230425	
TBCN_CONTRACT_COMPARE	
TBCN_CONTRACT_CONFIRM	[CN][계약] 신계약 확인 테이블
TBCN_CONTRACT_CONFIRM_UPLOAD	[CN][계약] 신계약 확인 업로드 테이블
TBCN_CONTRACT_CUSTGBN_MIG	
TBCN_CONTRACT_DATE_MIG	
TBCN_CONTRACT_DECRE_INCRE	[CN][계약] 감액/증액관리
TBCN_CONTRACT_ENDORSEMENT	[CN][계약] 자동차 배서관리
TBCN_CONTRACT_EXISTING_MONTH	[CN][계약] 계약마감관리
TBCN_CONTRACT_EXISTING_MONTH2	[CN][계약] 계약마감관리2
TBCN_CONTRACT_FAMILYEXCEPT	
TBCN_CONTRACT_JUMPO	[CN][계약] 점포관리
TBCN_CONTRACT_JUMPO_ASSIGN	[CN][계약] 점포배정관리
TBCN_CONTRACT_LTI	[CN][계약] 계약관리
TBCN_CONTRACT_LTI_20231001	[CN][계약] 계약관리
TBCN_CONTRACT_LTI_20231001_01	
TBCN_CONTRACT_LTI_EXCEPT	
TBCN_CONTRACT_MIG	
TBCN_CONTRACT_MIG2	
TBCN_CONTRACT_MIG22	
TBCN_CONTRACT_MIG_20230515	계약관리 임시 20230515
TBCN_CONTRACT_MIG_20231101	
TBCN_CONTRACT_MONTH	[CN][계약] 신계약마감관리
TBCN_CONTRACT_MONTH_PERFORMANCE	[CN][계약] 마감실적
TBCN_CONTRACT_MULTISHARE_APPROVAL	[CN][계약] 다건쉐어신청관리
TBCN_CONTRACT_PROD_CODE	
TBCN_CONTRACT_RAW_UPLOAD	[CN][계약] 계약관리
TBCN_CONTRACT_RAW_VERIFY	[CN][계약] 계약관리
TBCN_CONTRACT_RE0601	[CN][계약] 계약관리
TBCN_CONTRACT_RECEIPT	[CN][계약] 자동차 수납관리
TBCN_CONTRACT_RIDER_DISAGREE	RIDER 조회 제외자(삭제금지)
TBCN_CONTRACT_RIDER_MGRMIG	매니저계약(삭제금지)
TBCN_CONTRACT_RIDER_MONTH	[계약] 푸르덴셜 특약 마감
TBCN_CONTRACT_RIDER_MONTH_1018	
TBCN_CONTRACT_RIDER_MONTH_2	[계약] 푸르덴셜 특약 마감
TBCN_CONTRACT_RIDER_MONTH_20230816	
TBCN_CONTRACT_RIDER_MONTH_20230816_부활	
TBCN_CONTRACT_RIDER_MONTH_20230816_성립일	
TBCN_CONTRACT_RIDER_MONTH_20231001	[계약] 푸르덴셜 특약 마감
TBCN_CONTRACT_RIDER_MONTH_MIG	[계약] 푸르덴셜 특약 마감
TBCN_CONTRACT_RIDER_MONTH_MIG_20230530	[계약] 푸르덴셜 특약 마감 마이그 20230530
TBCN_CONTRACT_RIDER_MONTH_RSLT	[계약] 푸르덴셜_LTI_계산결과
TBCN_CONTRACT_RIDER_MONTH_RSLT_20230816	
TBCN_CONTRACT_RIDER_MONTH_RSLT_20231001	[계약] 푸르덴셜_LTI_계산결과
TBCN_CONTRACT_RIDER_MONTH_TESTT	
TBCN_CONTRACT_RIDER_MONTH_납면	
TBCN_CONTRACT_RIDER_MONTH_누락2	[계약] 푸르덴셜 특약 마감
TBCN_CONTRACT_RIDER_MONTH_부활	
TBCN_CONTRACT_RIDER_MST	[계약] 푸르덴셜 특약 마스터
TBCN_CONTRACT_RIDER_MST_0530RE	
TBCN_CONTRACT_RIDER_MST_20230801	[계약] 푸르덴셜 특약 마스터
TBCN_CONTRACT_RIDER_MST_20230816	[계약] 푸르덴셜 특약 마스터
TBCN_CONTRACT_RIDER_MST_LTI	[계약] 푸르덴셜 특약 마스터
TBCN_CONTRACT_RIDER_MST_LTI_20231001	[계약] 푸르덴셜 특약 마스터
TBCN_CONTRACT_RIDER_MST_LTI_20231001_01	
TBCN_CONTRACT_RIDER_MST_VER1	[계약] 푸르덴셜 특약 마스터2
TBCN_CONTRACT_RIDER_수정종신	
TBCN_CONTRACT_RIDER_수정종신확인필요	
TBCN_CONTRACT_SHARE	[CN][계약] 쉐어관리
TBCN_CONTRACT_SHARE_APPROVAL	[CN][계약] 쉐어신청관리
TBCN_CONTRACT_SHARE_APPROVAL_DETAIL	[CN][계약] 다건쉐어신청상세
TBCN_CONTRACT_SHARE_CHANGE_UPLOAD	[CN][계약] 관리사원 변경 업로드 테이블
TBCN_CONTRACT_SHARE_CLOSE_MONTH	[SY][시스템] 신계약쉐어 승인 마감관리
TBCN_CONTRACT_SHARE_HIST	[CN][계약] 쉐어관리 이력
TBCN_CONTRACT_SHARE_MONTH	[CN][계약] 신계약마감관리(쉐어적용)
TBCN_CONTRACT_SHARE_MONTH_MIG	
TBCN_CONTRACT_START_SOCIETY	[CN][계약] 사회초년생계약(일마감)
TBCN_CONTRACT_STATUS	[CN][계약] 계약상태관리
TBCN_CONTRACT_SUGUM_EMP_MONTH	[CN][계약] 인별 수금 자료
TBCN_CONTRACT_SUGUM_MONTH	[CN][계약] 건별 수금 자료
TBCN_CONTRACT_SUGUM_SCD_MONTH	[CN][계약] 조직별 수금 자료
TBCN_CONTRACT_TRANSFER_HIST	[CN]푸르덴셜계약이전관리목록
TBCN_CONTRACT_UPLOAD	[CN][계약] 계약관리 업로드 테이블
TBCN_CONTRACT_USI	[CN][계약] 건별 유지 자료
TBCN_CONTRACT_USI_DAY	[CN][계약] 건별 유지 자료
TBCN_CONTRACT_USI_EMP	[CN][계약] 인별 유지 자료
TBCN_CONTRACT_USI_EMP_DAY	[CN][계약] 인별 유지 자료
TBCN_CONTRACT_USI_EMP_REALTIME	[CN][계약] 실시간 일별 건별 유지 자료
TBCN_CONTRACT_USI_EXCEL	[CN][계약] 건별 유지 자료 엑셀 업로드 테이블
TBCN_CONTRACT_USI_EX_INSPOL	[CN][계약] 실시간 예상 유지율 증번관리
TBCN_CONTRACT_USI_EX_REALTIME	[CN][계약] 실시간 예상 유지율
TBCN_CONTRACT_USI_MO_SCD	[CN][계약] 모집 당시 조직코드별 유지 자료
TBCN_CONTRACT_USI_MO_SCD_DAY	[CN][계약] 모집 당시 조직코드별 유지 자료
TBCN_CONTRACT_USI_MO_SCD_REALTIME	[CN][계약] 일별 조직코드별 유지 자료
TBCN_CONTRACT_USI_REALTIME	[CN][계약] 실시간 일별 건별 유지 자료
TBCN_CONTRACT_USI_SCD	[CN][계약] 조직별 유지 자료
TBCN_CONTRACT_USI_SCD_DAY	[CN][계약] 조직별 유지 자료
TBCN_CONTRACT_USI_SCD_REALTIME	[CN][계약] 일별 조직별 유지 자료
TBCN_CUSTOMER	[CN][계약] 고객관리
TBCN_CUSTOMER_ACTIVITY	[CN][계약] 고객활동이력
TBCN_CUSTOMER_FAMILY	[CN][계약] 고객가족사항
TBCN_CUSTOMER_SAVE_DELETE	[CN][계약] 고객삭제전 저장
TBCN_DIV	
TBCN_DIV_230823_BAK	
TBCN_DIV_230829_BAK	
TBCN_EMP_AGCS_USI_RATE_MONTH	[계약] 인별 AGCS 유지율
TBCN_EXTERNAL_LENDING	
TBCN_EXTERNAL_LIST	
TBCN_EXTERNAL_VIEW	
TBCN_FAMILY_CONTRACT	
TBCN_FAMILY_CONTRACT_220922	
TBCN_FAMILY_CONTRACT_MIG	
TBCN_FC_RANKINGWEEK	
TBCN_FSS	
TBCN_FSS_230830_BAK	
TBCN_INCOME_NAFYC	
TBCN_INSPOL_FORM	[CN][계약] 보험사별 증권번호 형식
TBCN_LOWEST_NAFYC_MONTH	[계약] 이관용 최저실적 NAFYC
TBCN_LTI_DETAIL_CONFIRM	[PM][프로모션] LTI DETAIL 검증
TBCN_ORPHANCHK	
TBCN_PCC_LIST	상품비교확인서 파일
TBCN_PRODUCT	[CN][계약] 상품관리
TBCN_PRODUCT_GROUP	[CN][계약] 상품군관리
TBCN_PRODUCT_MIG	
TBCN_RIDER_MGR_POLICY_YN	[계약] 푸르덴셜 특약 마감
TBCN_SCD_RANKINGWEEK	
TBCN_SHARED_HISTORY	
TBCN_SHARED_HISTORY_MIG	
TBCN_SMAM_EMP_AGCS_USI_RATE_MONTH	[계약] SM,AM 인별 AGCS 유지율
TBHM_ACTION_LOG	[HM][홈페이지] 액션 로그
TBHM_BOARD	[HM][홈페이지] 게시판
TBHM_ERROR_LOG	[HM][홈페이지] 에러 로그
TBHM_FILE_INFO	[HM][홈페이지] 첨부파일정보
TBHM_ILLEGAL_REPORT	[HM][홈페이지] 불법광고신고
TBHM_ITEM	[HM][홈페이지] 게시글
TBHM_LOGIN	[HM][홈페이지] 로그인 정보
TBHM_LOGIN_HIST	[HM][홈페이지] 로그인 이력관리
TBHRB_FPQF	LP_자격정보
TBIN_ACCOUNT_APPROVAL	[IN][인사] 수당계좌변경신청 관리
TBIN_AFYC_NAFYC_HIS	[조회용 이력 테이블] 마감월 인별 AFYC, NAFYC
TBIN_APPOINT	[IN][인사] 발령관리
TBIN_APPR_LINE_HIST_MGT	결재라인이력관리
TBIN_APPR_LINE_MGT	결재라인관리
TBIN_APPR_PROC_INFO	결재진행정보
TBIN_BANK_MIG	
TBIN_BUSINESSCARD	[IN][인사] 명함신청
TBIN_CANDIDATE	[IN][인사] 후보자관리
TBIN_CANDIDATE_CHOICE_AM	
TBIN_CANDIDATE_FAMILY	[IN][후보자] 가족사항관리
TBIN_CANDI_ACAB_INFO	후보자학력정보
TBIN_CAND_CARR_INFO	후보자경력정보
TBIN_CAND_DOC_MGT	위촉후보서류관리
TBIN_CAND_FAM_INFO	후보자가족정보
TBIN_CAND_INFO	위촉후보자정보
TBIN_CAND_PROC_INFO	위촉후보자진행상태정보
TBIN_CERTIFICATE	[IN][인사] 증명서신청
TBIN_CERTIFICATE_HIST	[IN][인사] 증명서 발급 기록
TBIN_CHNG_RQST_INFO	인사변경신청정보
TBIN_CIS_EVAL_INFO	후보자CIS평가정보
TBIN_CONSULTING	[CN][계약] 상담신청관리(가망고객관리)
TBIN_CONTACT_NUMBER	[IN][인사] 연락처관리
TBIN_DISMISSAL	[IN][인사] 해촉 신청
TBIN_DISMISSAL_HIST	[IN][인사] 해촉 발급
TBIN_EMAIL_CONSULT	홈페이지 이메일 내용 적재
TBIN_EMPAPPOINT	[IN][인사] 인사발령
TBIN_EMPCODE	[IN][인사] 보험사사원코드관리
TBIN_EMPFAMILY	[IN][인사] 가족사항관리
TBIN_EMPGUARANTEE_ETC	[IN][인사] 기타담보관리
TBIN_EMPGUARANTEE_SEC	[IN][인사] 보증보험관리
TBIN_EMPGUARANTEE_SEC_MIG	
TBIN_EMPGUARANTEE_SEC_TEMP_20230510	[IN][인사] 보증보험관리 20230510 데이터 임시 보관용
TBIN_EMPMST	[IN][인사] 인사관리
TBIN_EMPMST_220730	[IN][인사] 인사관리
TBIN_EMPMST_BAK_231017	
TBIN_EMPMST_HIST	인사정보이력
TBIN_EMPMST_TMP	[IN][인사] 인사 업로드 테이블
TBIN_EMPMST_TMP2	
TBIN_EMP_CIC_INFO	우수인증설계사정보
TBIN_EMP_CMS_HIST	인사 수수료정보 이력
TBIN_EMP_FINC_LICS_INFO	금융자격정보
TBIN_EMP_MONTH	[IN][인사] 월별인사마감
TBIN_EMP_MONTH_0217	
TBIN_EMP_MONTH_202210_221123	
TBIN_EMP_MONTH_2207_220822	
TBIN_EMP_REL_INFO	직원관계정보
TBIN_EMP_REL_INFO_221209	
TBIN_EMP_REL_INFO_MIG	직원관계정보
TBIN_EMP_REWARD	[IN][인사] 상벌관리
TBIN_EMP_STAT_INFO	직원상태정보
TBIN_EMP_STAT_INFO2	직원상태정보2
TBIN_EMP_STAT_INFO_MONTH	직원상태정보 마감
TBIN_EMP_VACATION	[IN][인사] 인별휴가관리
TBIN_EMP_VACATION_APPLY	[IN][인사] 인별휴가신청관리
TBIN_ETC_EXAM_APPLY	[IN][인사] 응시/변액 시험신청관리
TBIN_EVAL_CANDIDATE_SM	[인사]SM후보실적
TBIN_EVAL_SM	
TBIN_EXAM	[IN][인사] 시험관리
TBIN_EXAM_APPLY	[IN][인사] 시험신청관리
TBIN_FC_DISCHARGE	최저자격기준(FC)
TBIN_FIRE_RQST_INFO	해촉신청정보
TBIN_GUARANTEE_ENTRY_MONTH	[IN][인사] 보증입보관리
TBIN_GUARANTEE_INCREMENT	[IN][인사] 보증보험 증액
TBIN_GUARANTEE_PAYROLL_DATA	
TBIN_INCREASE_TARGET_EMP	[IN][인사] 증액대상자
TBIN_INSA_CHNG_RQST_INFO	인사상세변경신청정보
TBIN_INSCO_CONTACT_NUMBER	[IN][인사] 제휴사연락처관리
TBIN_MIN_PRFM_CLOS_MONTH	최저실적마감정보(월별)
TBIN_MIN_PRFM_CLOS_MONTH_230802	
TBIN_MIN_PRFM_CLOS_MONTH_230804	
TBIN_MIN_PRFM_CLOS_MONTH_230821_BAK	
TBIN_MIN_PRFM_CLOS_MONTH_230830	
TBIN_MIN_PRFM_CLOS_MONTH_BAK_230926	
TBIN_MIN_PRFM_CLOS_MONTH_BK	
TBIN_MIN_PRFM_CLOS_MONTH_BK_0316	
TBIN_MIN_PRFM_CLOS_MONTH_BK_0413	
TBIN_MIN_PRFM_CLOS_MONTH_BK_0809	
TBIN_MIN_PRFM_CLOS_MONTH_BK_0814	
TBIN_MIN_PRFM_CLOS_MONTH_FINAL	
TBIN_MIN_PRFM_CMS_JIGUB_MONTH	[IN][인사] 최저실적 CMS 커미션 정보
TBIN_MIN_PRFM_CRTA_MGT	최저실적기준관리
TBIN_NEW_APPT_INFO	발령내역정보
TBIN_NEW_APPT_INFO_MIG	발령내역정보
TBIN_NEW_APPT_SCHE_INFO	발령내역예정정보
TBIN_OFFICE	[IN][인사] 지점관리
TBIN_OFFICE_230731	
TBIN_PENALTY_POINT	
TBIN_PENALTY_TYPE	
TBIN_POK_EMP_CHANGE	푸르덴셜 발령정보
TBIN_PRETS_EVAL_INFO	PRE-TS 평가정보
TBIN_PRETS_EVAL_MGT	PRE-TS 평가표관리
TBIN_SAVE_AMT_MONTH	[IN][인사] 적립금관리
TBIN_SAVE_TARGET_EMP_MONTH	[IN][인사] 적립금 대상자 관리(적립금공제의뢰)
TBIN_SCD	[ERP] 조직
TBIN_SCD_220730	[ERP] 조직
TBIN_SCD_220730_2	
TBIN_SCD_220816	
TBIN_SCD_221060	
TBIN_SCD_MAP	[ERP] 조직코드 맵핑(신규생성되어 코드가 꼬인 조직)
TBIN_SCD_MAP_MIG	
TBIN_SCD_MONTH	[IN][인사] 월별조직마감
TBIN_SCD_MONTH_2207_220822	
TBIN_SCD_MONTH_221122	
TBIN_SCOL_LIST_MGT	학교목록관리
TBIN_SPCL_JUDG_INFO	후보자특별심사정보
TBIN_SUPPLEMENT_EDU	[IN][인사] 보수교육
TBIN_TASK_TMP_STOP_INFO	위탁업무일시중지정보
TBIN_TS1_EVAL_INFO	후보자TS1평가정보
TBIN_WITHHOLDING	[IN][인사] 원천징수영수증 신청
TBIN_WITHHOLDING_RECEIPT	[IN][인사] 원천징수영수증 데이터
TBIN_WITHHOLDING_REQUEST	[IN][인사] 원천징수영수증 신청 - 엑셀업로드용
TBIN_WITHHOLDING_REQUEST_HIST	[IN][인사] 원천징수영수증 발급 기록 - 엑셀업로드용
TBMA_IMAGELINK_TYPE_IMAGES	[MA][메인] 이미지 링크 마스터에 등록된 이미지
TBMA_IMAGELINK_TYPE_MST	[MA][메인] 이미지 링크 유형 마스터
TBMA_TEMPLATE_MST	[MA][메인] 메인화면 설정 마스터
TBPC_AUTHENTICATION	[PC][인증] 본인인증
TBPC_AUTHENTICATION_LOGS	[PC][인증] 본인인증로그
TBPF_ACHIEVEMENT_RATE	[PF][실적관리] 달성율관리
TBPF_BESTFC_ACHIEVEMENT_EMP	[PF][실적] 우수FC 인별
TBPF_BESTFC_ACHIEVEMENT_SCD	[PF][실적] 우수FC 조직별
TBPM_BEST_ROOKIE_MST	[PM]BEST ROOKIE REPORT
TBPM_BEST_ROOKIE_MST_BK	
TBPM_BEST_ROOKIE_MST_BK2	
TBPM_CP_KEEP	[PM][프로모션] CP 유지율테이블
TBPM_CP_RESULT	[PM][프로모션] CP 실적테이블
TBPM_LTI_CALC_RSLT	[PM][프로모션] LTI 계산 결과
TBPM_LTI_CALC_RSLT_20230807	
TBPM_LTI_CALC_RSLT_20230816	
TBPM_LTI_CALC_RSLT_5월	[PM][프로모션] LTI 계산 결과
TBPM_LTI_CALC_RSLT_BK	
TBPM_LTI_CALC_RSLT_CONFIRM	[PM][프로모션] LTI 계산 결과 검증
TBPM_LTI_CALC_RSLT_MIG_REAL	[PM][프로모션] LTI기지급자
TBPM_LTI_CALC_RSLT_MIG_REAL_RE	[PM][프로모션] LTI기지급자_대상자만
TBPM_LTI_CALC_RSLT_MIG_REAL_RE2	[PM][프로모션] LTI기지급자_대상자만
TBPM_LTI_CALC_YMD	[PM][프로모션] LTI 산출일 이월 저장 정보
TBPM_LTI_EXCEPT_PRODUCT	[PM] 제외 상품
TBPM_LTI_OPEN_CONFIG	[PM][프로모션] LTI 오픈 설정
TBPM_LTI_PRODUCT	[PM] LTI상품관리
TBPM_LTI_PRODUCT_20230816	
TBPM_MDRT_COMM_REPORT	[PM][프로모션] MDRT 커미션 REPORT
TBPM_MDRT_COMM_REPORT_202308	
TBPM_MDRT_COMM_REPORT_231107_BAK	
TBPM_MDRT_COUNT	[PM][프로모션] MDRT 횟수변경
TBPM_MDRT_COUNT_HIST	[PM][프로모션] MDRT 횟수변경 이력
TBPM_MDRT_CRITERIA	[PM][프로모션] MDRT 입회기준
TBPM_MDRT_FILE_INFO	[PM][프로모션] MDRT 첨부파일정보
TBPM_MDRT_INFO	[PM][프로모션] MDRT 정보
TBPM_MDRT_INSA_MIG	
TBPM_MDRT_INS_REPORT	[PM][프로모션] MDRT 보험료 REPORT
TBPM_MDRT_MONTH_REPORT	[PM][프로모션] MDRT 월별 리포트
TBPM_MDRT_MONTH_REPORT_231107_BAK	
TBPM_MDRT_OPEN_MONTH	[PM][프로모션] MDRT 오픈관리
TBPM_MDRT_TOTAL_REPORT	[PM][프로모션] MDRT 총수입 REPORT
TBPM_MDRT_TOTAL_REPORT_202308	
TBPM_MDRT_TOTAL_REPORT_231107_BAK	
TBPM_ST_CLS_LOG	[PM] SHORT TERM 마감 로그 
TBPM_ST_CONTRACT	[PM] SHORT TERM 계약관리 마감 데이터
TBPM_ST_CONTRACT_SHARE	[PM] SHORT TERM 쉐어관리 마감 데이터
TBPM_ST_EMPMST	[PM] SHORT TERM 인사관리 마감 데이터
TBPM_ST_EXCLUDE_CONTRACT	[PM] ST 제외증번 관리
TBPM_ST_LP_DETAIL_REPORT	[PM] SHORT TERM LP 레포트 디테일 결과 테이블(조직이동 데이터 포함)
TBPM_ST_LP_REPORT	[PM] SHORT TERM LP 레포트 결과 테이블(조직이동 데이터 포함)
TBPM_ST_MACAUR_DETAIL_REPORT	[PM] SHORT TERM 마카오 리쿠르팅 디테일 결과 테이블
TBPM_ST_MACAUR_REPORT	[PM] SHORT TERM 마카오 리쿠르팅 결과 테이블
TBPM_ST_SCD	[PM] SHORT TERM 조직 마감 데이터 
TBPM_ST_SLC	[ST] SLC 대상자 관리
TBPM_ST_SLC_RECRUITING	[ST] SLC 대상자 리쿠르팅 관리
TBPM_ST_TEAM_REPORT	[PM] SHORT TERM SM/AM 레포트 결과 테이블
TBPM_THREE_WEEK_BUSINESS	[PM]3W영업주관리
TBPM_THREE_WEEK_BUSINESS_MIG	[PM]3W영업주관리
TBPM_THREE_WEEK_CHG_HIS	[PM]3W주차변경이력
TBPM_THREE_WEEK_CONTRACT	[PM]3W계약상품
TBPM_THREE_WEEK_CONTRACT_230823	
TBPM_THREE_WEEK_CONTRACT_MGN	[PM]3W계약상품마이그레이션
TBPM_THREE_WEEK_EXCEPTIONS	3W 예외처리관리
TBPM_THREE_WEEK_MAP	[PM]3W계약매핑
TBPM_THREE_WEEK_MAP_230823_BAK	
TBPM_THREE_WEEK_MAP_MGN	[PM]3W계약매핑마이그레이션
TBPM_THREE_WEEK_MST	[PM] 3W달성관리
TBPM_THREE_WEEK_MST_230823_BAK	
TBRI_ASSET_MANAGER	[RI][리스크] 자산현황 관리
TBRI_CONTRACT_EMP_MONTH	[RI][리스크] 인별 신계약 리스크 자료
TBRI_CONTRACT_OVERDUE_MONTH	[RI][리스크] 건별 연체 자료
TBRI_CONTRACT_SCD_MONTH	[RI][리스크] 조직별 신계약 리스크 자료
TBRI_DIFFERENT_EMP_MONTH	[RI][리스크] 인별 모집/수금자 상이 자료
TBRI_DIFFERENT_SCD_MONTH	[RI][리스크] 조직별 모집/수금자 상이 자료
TBRI_HIGHEVALUATION_CONFIG	[RI][리스크] 고평가 기준금액 설정관리
TBRI_HIGHPRICE_COLLECT_CONTRACT_MONTH	[RI][리스크] 고액계약 수금 마감관리
TBRI_HIGHPRICE_CONFIG_MONTH	[RI][리스크] 고액계약 기준금액 설정관리
TBRI_INCOMPLETE_SALE_HIST	
TBRI_INCOMPLETE_SALE_KB	
TBRI_INCOMPLETE_SALE_MONTH	[RI][리스크] 불완전판매 계약
TBRI_INCOMPLETE_SALE_PROGRESS	[RI[리스크] 민원관리 진행사항
TBRI_INCOMPLETE_SALE_STATUS_MONTH	[RI][리스크] 불완전판매 계약 상태관리
TBRI_OVERDUE_EMP_MONTH	[RI][리스크] 인별 연체 자료
TBRI_OVERDUE_SCD_MONTH	[RI][리스크] 조직별 연체 자료
TBRI_SELLINGRISK_CONFIG_MONTH	[RI][리스크] 판매리스크 설정관리
TBRI_SELLINGRISK_CONTRACT_MONTH	[RI][리스크] 월별 판매리스크 계약
TBRI_SELLINGRISK_EMP_MONTH	[RI][리스크] 인별 판매리스크 자료
TBRI_SELLINGRISK_SCD_MONTH	[RI][리스크] 조직별 판매리스크 자료
TBSP_CMDBDISTRIBUTION	[SP][영업] DB 관리
TBSP_CMDBDISTRIBUTION_APPLY	[SP][영업] DB 신청
TBSP_CMDBDISTRIBUTION_ITEM_MAPPING	[SP][영업] DB 항목관리
TBSP_CMDBDISTRIBUTION_MEETING	[SP][영업] DB 미팅관리
TBSP_CMDBDISTRIBUTION_STATUS	[SP][영업] DB분배 상태이력 관리
TBSP_CMDBDISTRIBUTION_WITHDRAW	[SP][영업] DB회수(반환) 관리
TBSP_CMDB_UPLOAD_EXCEL_MST	[SP][영업] DB 입수 엑셀 마스터
TBSP_ELECTRONIC_SIGNATURES	[SY][시스템] 전자서명
TBSP_ELECTRONIC_SIGNATURES_MST	[SY][시스템] 전자서명 마스터
TBSP_POPUP_MANAGEMENT	[SY][시스템] 전자서명 TYPE2
TBSP_POPUP_MANAGEMENT_MST	[SY][시스템] 전자서명 TYPE2 마스터
TBSP_SCHEDULE	[SP][영업] 일정관리
TBSY_ACTION_LOG	[SY][시스템] 액션 로그
TBSY_BOOKMARK	[SY][시스템] 즐겨찾기
TBSY_CLOSE_MONTH	[SY][시스템] ERP마감관리
TBSY_COPYMONTH_ALL_LOG	[SY][시스템] PRC_COPYMONTH_ALL 로그
TBSY_COPYMONTH_LOG	[SY][시스템] TBSY_COPYMONTH_LOG 로그
TBSY_ERROR_LOG	[SY][시스템] 에러 로그
TBSY_ETC_CLOSE_MONTH	[SY][시스템] 기타 화면 마감관리
TBSY_EXCEL_DOWN_APPROVAL	[SY][시스템] 엑셀다운로드 신청
TBSY_FILE_INFO	[SY][시스템] 첨부파일정보
TBSY_FILE_INFO_2022_12_27	
TBSY_FILE_INFO_BACKUP_TRIGGER	[SY][시스템] 첨부파일정보 백업(트리거)
TBSY_HELP_ITEM	[SY][시스템] 도움말관리
TBSY_INSA_ALL_LOG	[SY][시스템] 인사용 로그
TBSY_LOGIN	[SY][시스템] 로그인 정보
TBSY_LOGIN_AUTH_NUM	[SY][시스템] 로그인 SMS인증번호관리
TBSY_LOGIN_HIST	[SY][시스템] 로그인 이력관리
TBSY_LUNA_TO_SOLAR	[SY][시스템] 양/음력 맵핑테이블
TBSY_MEMBER	[SY][시스템] 회원사관리
TBSY_PDF_INFO	[SY][시스템] PDF 정보
TBSY_PDF_PARAM_INFO	[SY][시스템] PDF 파라미터 정보
TBSY_RESOURCES	[SY][시스템] 메뉴
TBSY_RESOURCES_DEV_NSGA	[SY][시스템] NSGA 임시 리소스 테이블
TBSY_RESOURCES_ROLE	[SY][시스템] 메뉴-롤 매핑/권한설정
TBSY_RESOURCE_DEFAULT_MONTH	[SY][시스템] 메뉴별 기준일
TBSY_ROLES_HIERARCHY	[SY][시스템] 롤계층구조
TBSY_ROLES_MAP	[SY][시스템] 롤마스터
TBSY_RPA_EXCEL_MST	[SY][시스템] RPA - 엑셀 맵핑 마스터
TBSY_RPA_LOG	[SY][시스템] RPA 로그
TBSY_SMS_LOG	[SY][시스템] SMS 로그
TBSY_SMS_UPLOAD	[SY][시스템] SMS 업로드
TBSY_SSO_KEY	[SY][시스템] 로그인 SSO KEY 관리
TBSY_TOKEN_HIST	[SY][시스템] API 토큰 관리
TBSY_UPLOAD_EXCEL_DATA_MONTH	[SY][시스템] 월별 입수 엑셀 데이터
TBSY_UPLOAD_EXCEL_MAPPING_CHK_MONTH	[SY][시스템] 입수 엑셀 월별 맵핑 확인용
TBSY_UPLOAD_EXCEL_MAPPING_MONTH	[SY][시스템] 입수 엑셀 월별 맵핑
TBSY_UPLOAD_EXCEL_MAPPING_MST	[SY][시스템] 입수 엑셀 맵핑마스터
TBSY_UPLOAD_EXCEL_MST	[SY][시스템] 입수 엑셀 마스터
TBSY_UPLOAD_EXCEL_STATUS_MONTH	[SY][시스템] 월별 입수 엑셀 업로드 정보
TBSY_UPLOAD_MAPPING_ERRCODE_MONTH	[SY][시스템] 월별 업로드 데이터 맵핑 에러 코드
TBSY_UPLOAD_MAPPING_ERRCODE_MST	[SY][시스템] 맵핑 에러 데이터 코드 관리
TBSY_UPLOAD_TABLE_MST	[SY][시스템] 엑셀 업로드 테이블 마스터
TBSY_USER_AUTH_HIST	[SY][시스템] 인증기록관리
TBSY_USER_AUTH_NUM	[SY][시스템] 인증번호관리
TBSY_USER_ROLE_MAP	[SY][시스템] 사용자-롤맵
TBVD_PLAY_USER	[VD][영상] 영상 조회기록
TBVD_VIDEO	[VD][영상] 영상관리
TBVD_VIDEO_LOG	[VD][영상] 영상시청기록
TBVD_VIDEO_MAIN_CATEGORY	[VD][동영상관리] 동영상 카테고리 대분류
TBVD_VIDEO_MIDDLE_CATEGORY	[VD][동영상관리] 동영상 카테고리 중분류
TBVD_VIDEO_SCHEDULE	[VD][영상] 영상 편성표 관리
TBVD_VIDEO_TAG	[VD][영상] 영상태그관리
TB_CONTRACT_AFYC_PAST_CONTRACT	[CN][계약] ERP 이관용 AFYC 데이터(과거계약)
TB_CONTRACT_RIDER_MST_RELAY_0530	ERP 이관용 특약데이터 마스터
TB_CONTRACT_RIDER_MST_RELAY_0530_2	ERP 이관용 특약데이터 마스터
TB_CONTRACT_RIDER_MST_RELAY_0615_ADD	[CN][계약] 푸르덴셜 정보계 특약_마스터
TB_CONTRACT_SHARE_RELAY_MIG	
TB_ECS_PLAN_NAME	푸르덴셜 정보계 보험즁류_명칭
TB_ECS_POLICY_MSTS_ALL	푸르덴셜 정보계 계약_마스터 - 전체계약
TB_ECS_RIDER_4월버전1누락	
TB_ECS_RIDER_MSTS_ALL	[CN][계약] 푸르덴셜 정보계 특약_마스터 - 전체
TB_ECS_RIDER_MSTS_ALL_0601	[CN][계약] 푸르덴셜 정보계 특약_마스터 - 전체
TB_ECS_RIDER_MSTS_ALL_비교	[CN][계약] 푸르덴셜 정보계 특약_마스터 - 전체
TB_ECS_UNIFYCODE	푸르덴셜 정보계 통합코드 테이블
TB_LIT_TARGET_EMP	
TB_PFM_CSBY_POLICY_RATE_MIG	
TEMP_HWAN_RATE	
TEMP_TABLE1	
TEST_EMP	
UPLOADTEMP	
V_FAMILY_CONTRACT_AFTER_OPEN	VIEW
V_ORG_CTE	VIEW
V_TBCN_CONTRACT	VIEW
V_TBCN_CONTRACT_CONFIRM	VIEW
V_TBCN_CONTRACT_CONFIRM_UPLOAD	VIEW
V_TBCN_CONTRACT_EXISTING_MONTH	VIEW
V_TBCN_CONTRACT_MONTH	VIEW
V_TBCN_CONTRACT_SHARE_MONTH	VIEW
V_TBCN_CONTRACT_START_SOCIETY	VIEW
V_TBCN_CONTRACT_UPLOAD	VIEW
V_TBCN_CUSTOMER	VIEW
V_TBCN_CUSTOMER_FAMILY	VIEW
V_TBCN_CUSTOMER_SAVE_DELETE	VIEW
V_TBIN_ACCOUNT_APPROVAL	VIEW
V_TBIN_CANDIDATE	VIEW
V_TBIN_EMPMST	VIEW
V_TBIN_EMPMST_CANNON	VIEW
V_TBIN_EMP_MONTH	VIEW
V_TBIN_ETC_EXAM_APPLY	VIEW
V_TBIN_EXAM_APPLY	VIEW
V_TBIN_SCD_CANNON	VIEW
V_TBIN_WITHHOLDING_RECEIPT	VIEW
V_TBRI_HIGHPRICE_COLLECT_CONTRACT_MONTH	VIEW
정보계계약환율	
정보계업데이트	
푸르덴셜_상품마이그_20230116	
SU_CASE_EVALUATION_MONTH	[정보계] 건별 평가성적
TBCN_CONTRACT_RIDER_MONTH_MIG	[ERP LTI] 특약청약당시마이그
TB_AFYC_NAFYC	[ERP 이관용] 마감월 인별 AFYC, NAFYC
TB_ALW_ALWNC_DTL	푸르덴셜 정보계 수당명세 테이블 - 전체
TB_ALW_ALWNC_HIS	[수수료] 수당이력
TB_ALW_ALWNC_ITM_CD	[수수료] 푸르덴셜 정보계 수당항목코드 테이블
TB_CASE_AGCS_USI_RATE_MONTH	[CN][계약] ERP 이관용 건별 AGCS 유지율
TB_CASE_SMAM_AGCS_USI_RATE_MONTH	[POK] 푸르덴셜 건별 SM/AM AGCS 유지 자료
TB_CONTRACT_AFYC	[CN][계약] ERP 이관용 AFYC 데이터
TB_CONTRACT_RELAY	중계DB ERP 이관용 계약관리 테이블
TB_CONTRACT_RELAY2	중계DB ERP 이관용 계약관리 테이블2
TB_CONTRACT_RELAY_0530	[ERP 이관용] 마감월 인별 AFYC, NAFYC
TB_CONTRACT_RELAY_0531	[ERP 이관용] 마감월 인별 AFYC, NAFYC
TB_CONTRACT_RELAY_0601	[ERP 이관용] 마감월 인별 AFYC, NAFYC
TB_CONTRACT_RELAY_20231001	중계DB ERP 이관용 계약관리 테이블
TB_CONTRACT_RELAY_LTI	
TB_CONTRACT_RIDER_MST_RELAY	[CN][계약] ERP 이관용 특약데이터 마스터
TB_CONTRACT_RIDER_MST_RELAY2	[CN][계약] ERP 이관용 특약 마스터 데이터2
TB_CONTRACT_RIDER_MST_RELAY_0531	
TB_CONTRACT_RIDER_MST_RELAY_0601	
TB_CONTRACT_RIDER_MST_RELAY_20230801	ERP 이관용 특약데이터 마스터
TB_CONTRACT_RIDER_MST_RELAY_20230814	[CN][계약] ERP 이관용 특약데이터 마스터
TB_CONTRACT_RIDER_MST_RELAY_20230816	ERP 이관용 특약데이터 마스터
TB_CONTRACT_RIDER_MST_RELAY_20231001	[CN][계약] ERP 이관용 특약데이터 마스터
TB_CONTRACT_RIDER_MST_RELAY_VER1	
TB_CONTRACT_RIDER_MST_RELAY_VER2	[CN][계약] ERP 이관용 특약데이터 마스터
TB_CONTRACT_SHARE_RELAY	중계DB ERP 이관용 계약쉐어관리
TB_ECS_BENEFICIARY_MST_RELAY	푸르덴셜 정보계 수익자정보
TB_ECS_CLIENT_MSTS	푸르덴셜 정보계 고객마스터
TB_ECS_CLIENT_MSTS_ALL	푸르덴셜 정보계 고객마스터-전체
TB_ECS_EFT_ACCOUNT	푸르덴셜 정보계 자동이체_계좌
TB_ECS_POLICY_MSTS	푸르덴셜 정보계 계약_마스터
TB_ECS_PREM_PAY	푸르덴셜 정보계 보험료입금 테이블(계약)
TB_ECS_PREM_PAY_ALL	푸르덴셜 정보계 보험료입금 테이블(계약) - 전체
TB_ECS_RIDER_MSTS	[CN][계약] 푸르덴셜 정보계 특약_마스터
TB_ECS_RIDER_MSTS_MIG	푸르덴셜 정보계 특약_마스터
TB_ECS_SHARED_POL_HISTORY	푸르덴셜 정보계 공동계약 이력
TB_ECS_SHARED_POL_HISTORY_ALL	푸르덴셜 정보계 공동계약 이력 전체
TB_EMPFAMILY_RELAY	중계DB ERP 이관용 가족사항
TB_EMPMST_RELAY	중계DB ERP 이관용 인사관리
TB_EMP_AGCS_USI_RATE_MONTH	[CN][계약] ERP 이관용 인별 AGCS 유지율
TB_HRM_CHANGE	푸르덴셜 정보계 발령사항
TB_HRM_DEPT	푸르덴셜 정보계 조직
TB_HRM_EMP	푸르덴셜 정보계 인사
TB_HRM_HR_DTL	중계DB 정보계 인사명세(인사마감)
TB_HRM_REL_MNG	푸르덴셜 관계관리
TB_HRM_STAT_MNG	푸르덴셜 상태관리
TB_INCOME_NAFYC	[CN][계약] ERP 이관용 AFYC 데이터
TB_LOWEST_NAFYC_RELAY	이관용 최저실적 NAFYC
TB_OSD_PREMIUM_INCOME	
TB_PFM_CSBY_POLICY_PRFM_HIS	[수수료] 푸르덴셜 정보계 건별계약실적이력
TB_PFM_CSBY_POLICY_RATE_RELAY	중계DB ERP 이관용 특약별커미션률 테이블
TB_PFM_CSBY_POLICY_RSLT_HIS	[수수료] 푸르덴셜 정보계 건별계약(실적)결과이력
TB_PFM_EVNT_POLICY_PRFM_HIS	[수수료] 푸르덴셜 정보계 이벤트계약실적이력
TB_PROCEDURE_EXEC_LOG	[SY][시스템] 프로시저 실행 로그
TB_PROCEDURE_LOG	[SY][시스템] 프로시저 실행 로그
TB_PRU_PROCEDURE_EXEC_LOG	[SY][시스템] 프로시저 실행 로그
TB_SCD_RELAY	중계DB ERP 이관용 조직 테이블
TB_SMAM_EMP_AGCS_USI_RATE_MONTH	ERP 적재용 SM,AM 인별 AGCS 유지율
R_CONTRACT	RPA 신계약 테이블
R_CONTRACT_RECEIPT	
TEST_TABLE	[SY] 보험사 공통코드 비교 테이블
LP_EXIST	LP실적 통계데이터를 생성.(특정월을 지정해 호출.)
PRC_AUTO_DBDISTRIBUTION	DB 자동분배 프로시저
PRC_BATCH_DBDISTRIBUTION	DB분배 일괄처리 프로시저
PRC_CALC_BUSINESS_DAY	당년도 영업일 계산 프로시저
PRC_CALC_PTC	PTC 계산 프로시저 집합
PRC_CALC_PTC_ANN_EMP_CNT	PTC 실제연인수 관리(마감월)
PRC_CALC_PTC_ANN_EMP_CNT_ORIGIN	PTC 실제연인수 관리(마감월)
PRC_CALC_PTC_ANN_EMP_CNT_ORIGIN_230726	PTC 실제연인수 관리(마감월)
PRC_CALC_PTC_CREATE_CONTRACT	월별 PTC 계약 생성
PRC_CALC_PTC_CREATE_CONTRACT_ALTR	월별 PTC 계약 생성(230629 수정중)
PRC_CALC_PTC_LP	PTC - LP, SM, AM 계산
PRC_CALC_PTC_LP_0913TEST	PTC - LP, SM, AM 계산
PRC_CALC_PTC_LP_230706	PTC - LP, SM, AM 계산
PRC_CALC_PTC_LP_230822_BAK	PTC - LP, SM, AM 계산
PRC_CALC_PTC_LP_230829_BAK	PTC - LP, SM, AM 계산
PRC_CALC_PTC_LP_230911_BAK	PTC - LP, SM, AM 계산
PRC_CALC_PTC_LP_ALTR	PTC - LP, SM, AM 계산(230629 수정중)
PRC_CALC_PTC_LP_L33_USIRATE_BACKUP	PTC - LP, SM, AM 계산
PRC_CALC_PTC_LP_ORIGIN	PTC - LP, SM, AM 계산
PRC_CLOSE_CONTRACT_RIDER_MONTH	특약 월마감 프로시저, 영업일 1일차에 1번(CLS_VER_NO = 1), 영업일 6일차에 1번(CLS_VER_NO = 2)로 생성, 에러시 -1, 성공시 1 리턴
PRC_CLOSE_CONTRACT_RIDER_RLST_MONTH	특약 월마감 CLS_VER_NO  = 2 생성완료 후, 16일에 디테일 생성
PRC_CLOSE_DAY	일마감 프로시저
PRC_COPYMONTH	마감관리 프로시저
PRC_CP_RESULT_CAL	실적통계 배치
PRC_CP_RESULT_SAVE	실적통계 배치
PRC_CREATEMONTH	마감월 생성 프로시저
PRC_CREATEMONTH_ALL	스케줄러 마감월 생성 프로시저
PRC_CREATEMONTH_SCHEDULER	스케줄러 마감월 생성 프로시저
PRC_CREATEPRFMLP	LP실적 통계데이터를 생성.
PRC_CREATEPRFMLP2	LP실적 통계데이터를 생성.
PRC_CREATEPRFMLP_BAK_230926	LP실적 통계데이터를 생성.
PRC_CREATEPRFMLP_CALL	LP실적 통계데이터를 생성.(특정월을 지정해 호출.)
PRC_CREATEPRFMLP_CALL2	LP실적 통계데이터를 생성.(특정월을 지정해 호출.)
PRC_CREATEPRFMLP_CMS	LP실적 통계데이터를 생성.
PRC_CREATEPRFMLP_EXIST	LP실적 통계데이터를 생성.(특정월을 지정해 호출.)
PRC_CREATEPRFMLP_EXIST2	LP실적 통계데이터를 생성.(특정월을 지정해 호출.)
PRC_CREATEPRFMLP_EXIST_230802	LP실적 통계데이터를 생성.(특정월을 지정해 호출.)
PRC_CREATEPRFMLP_EXIST_CMS_MONTH	LP실적 통계데이터를 생성.(특정월을 지정해 호출.)
PRC_CREATEPRFMLP_EXIST_MONTH	LP실적 통계데이터를 생성.(특정월을 지정해 호출.)
PRC_CREATEPRFMLP_EXIST_MONTH_BAK_230926	LP실적 통계데이터를 생성.(특정월을 지정해 호출.)
PRC_DELETEMEMBER	회원사 삭제 프로시저
PRC_DEL_BUSINESS_WEEK	
PRC_EXCELUPLOADERRCHK	엑셀업로드 에러체크 프로시저
PRC_NEWMEMBER	새 회원사 입력 프로시저
PRC_UPLOADEXCELINCHANGEDATA	
PRC_UPLOADEXCELSAVEDATA	엑셀업로드 목적지 테이블 입력 프로시저
PRC_USI_CLOSE_DAY	일 단위 유지율 마감
PRC_USI_CLOSE_DAY_NEW	당월 일 단위 유지율 마감
PRC_PROCESSCONTRACTRELAYDATA	푸르덴셜 정보계에서 생성된 이관용 데이터로 ERP 데이터 갱신(계약 데이터)
PRC_PROCESSCONTRACTRELAYDATA2	푸르덴셜 정보계에서 생성된 이관용 데이터로 ERP 데이터 갱신(계약의 AFYC, NAFYC)
PRC_PROCESSCONTRACTRELAYDATA_20230814	푸르덴셜 정보계에서 생성된 이관용 데이터로 ERP 데이터 갱신(계약 데이터)
PRC_PROCESSCONTRACTRELAYDATA_20230816	푸르덴셜 정보계에서 생성된 이관용 데이터로 ERP 데이터 갱신(계약 데이터)
PRC_PROCESSCONTRACTRELAYDATA_20231001	푸르덴셜 정보계에서 생성된 이관용 데이터로 ERP 데이터 갱신(계약 데이터)
PRC_PROCESSCONTRACTRELAYDATA_MIG	
PRC_PROCESSCONTRACTRELAYDATA_TEMP	
PRC_PROCESSCONTRACTRELAYDATA_TEMP2	
PRC_PROCESSEMPRELAYDATA	푸르덴셜 정보계에서 생성된 이관용 데이터로 ERP 데이터 갱신(인사 데이터)
SU_CNT_HWANSU_RATE_MONTH_ORIGIN	
SU_CNT_HWANSU_RATE_MONTH	[SU][수수료]회차별 환수율
SU_SCD_MONTH_20221122	
SU_EMP_PAYROLL_SUJI_MONTH	[SU][수수료] 인별 명세항목별 수입 대비 지급
SU_CONVERSION_RATE_MONTH	[SU][수수료] 변환율관리
SU_SCD_OVERRIDE_RATE_MONTH	[SU][수수료] 조직별 오버라이드 정보
SU_GEN_JIGUB_PROCESS_MONTH	[SU][지급] 일반 증권번호별
SU_JIGUB_CALC_MST_MONTH	
SU_COMM_EMP_USI_RATE_MONTH_UPLOAD	[SU][수수료]수수료 인별 유지율업로드
SU_INSPOL_POLICY_MONTH	[SU][수수료] 시책(증권번호별)
SU_CONTRACT_MONTH	[SU][계약] 계약관리
SU_APPLY_ERP_DATA_LOG	[SU][수수료] ERP 데이터 적용 로그
SU_REC_STANDARD_DATA_MONTH	[SU][수수료] 리크루팅 계산마스터(지급표준 - 장기, 일시납)
SU_JIGUB_ACM_MONTH	[수수료] 월별 누적금
SU_CF_VALUE_MONTH	[수수료]조직별 불완전판매율 관리
SU_CONTRACT_STATUS_CONF	[SU][수수료] 계약상태 설정
SU_EMPCODE_MONTH	[SU][수수료] 월별 보험사 사원코드관리
SU_SCD_JIGUB_RATE_MONTH	[SU][수수료] 조직별 지급율
SU_JIGUB_GEN_CALC_RULE_MONTH	[SU][수수료] FC 일반 수수료 설정 규정관리
SU_SUIP_AMT_MONTH	[SU][수수료]수입수수료 계산된 데이터
SU_SUIP_STAT_AMT_SCD_MONTH	[SU][수수료]월별 수입수수료 명세서 금액 데이터
SU_SUIP_STD_MST_MONTH	[SU][수수료]월별 표준데이터 마스터
SU_SUIP_STANDARD_REDUCE_MONTH	[SU][수수료]표준데이터 감액/승환 확인
SU_SCD_EVALUATION_MONTH	[SU][수수료]조직별 평가성적
TBSY_CLOSE_MONTH	[SY][시스템]마감 관리
SU_TEAM_CARRIED_RETURN_MONTH	[SU][수수료] 팀장,BM 누계환수
TBSY_UPLOAD_EXCEL_MAP_MST	[SY][시스템] 입수 엑셀 맵핑마스터
SU_COMM_SCD_USI_RATE_MONTH	[SU][수수료]조직별 유지율
SU_SUIP_STANDARD_NEWCONT_MONTH	[SU][수수료]표준데이터 신계약 확인
SU_OVR_CONTRACT_MST_MONTH	[SU][수수료]오버라이드 계약마스터
TBSY_UPLOAD_EXCEL_MAP_MONTH	[SY][시스템] 입수 엑셀 월별 맵핑
SU_JIGUB_RULE_MONTH	[SU][수수료] 지급규정관리
SU_IS_RATE_SCD_MONTH	[수수료]조직별 불완전판매율 관리
SU_JIGUB_CAR_CALC_MST_MONTH	FC 자동차 수수료(지급수수료) 설정
SU_SUIP_STAT_MST_MONTH	[SU][수수료]월별 수입수수료 명세서 계산 마스터
SU_SUGUM_EMP_MONTH	[SU][수수료]인별 수금율
SU_ETC_CASE_CUSTOMER_MONTH	[SU][수수료]기타성 수수료 - 건별 고객가치증대지원수수료
SU_SUIP_STAT_MANUAL_MONTH	[SU][수수료]월별 수입수수료 명세서 수기입력 테이블
SU_EMP_SAVING_PROCESS_MONTH	[SU][수수료] 인별 적립금 확인 테이블
SU_USI_EMP_MONTH	[SU][수수료]인별 유지율
SU_CONTRACT_SHARE_CHANGE_MONTH	[SU][수수료] 수금이관(계약쉐어변경이력)
SU_SCD_JIGUB_DEFAULT_MONTH	[SU][수수료] 조직별 지급율 기본값 설정 테이블
SU_SUIP_STANDARD_DATA_MONTH	[SU][수수료]수입수수료 표준데이터
TBSY_UPLOAD_EXCEL_MAPCHK_MONTH	[SY][시스템] 입수 엑셀 월별 맵핑 확인용
SU_OVR_STANDARD_DATA_MONTH	[SU][수수료] 오버라이드 계산마스터(지급표준 - 장기, 일시납)
SU_EMP_OVERRIDE_RATE_MONTH	[SU][수수료] 인별 오버라이드 설정
SU_SAVING_TARGET_EMP_MONTH	[SU][수수료] 적립대상자
SU_SUIP_COM_RULE_MONTH	[SU][수수료]월별 수입수수료 계산마스터 규정관리
SU_OVR_BUNGUB_DATA_MONTH	[SU][수수료] 오버라이드 분급
SU_SUIP_RATE_MONTH	[SU][수수료] 수입수수료 지급율 관리
SU_EMP_INSCO_PROCESS_MONTH	[TEMP][수수료] 인별-보험사별 지급수수료
SU_SCD_PAYROLL_SUJI_MONTH	[SU][수수료] 조직별 명세항목별 수입 대비 지급
SU_SUIP_COM_MST_MONTH	[SU][수수료]월별 수입수수료 계산마스터
SU_CONTRACT_NAPMETHOD_CONF	[SU][수수료] 납입방법 설정
SU_ERP_DATA_CONFIG_MST_MONTH	[SU][수수료] ERP 데이터 가져오기 설정 마스터
SU_RSGN_JIGUB_PROCESS_MONTH	[SU][지급] 부지급자 지급수수료 증권번호별 - 장기
SU_CASE_EVALUATION_MONTH	[SU][수수료]건별 평가성적
SU_OTHER_FEES_TYPE	[SU][수수료] 기타지급 및 공제 항목 설정
SU_COMM_EMP_USI_RATE_MONTH	[SU][수수료]수수료 인별 유지율
TBCM_INSCO	[CM][공통]  보험사
SU_SUIP_STANDARD_STAT_MONTH	[SU][수수료]표준데이터 명세서
SU_EMP_SAVING_RSLT_MONTH	[SU][수수료] 인별 적립금 결정 테이블
TBSY_UPLOAD_MAP_ERRCODE_MONTH	[SY][시스템] 월별 업로드 데이터 맵핑 에러 코드
SU_EMP_JIGUB_RATE_MONTH	[SU][수수료]인별지급율
TBIN_SCD	[IN][인사] 조직관리
SU_COMM_CONTRACT_USI_RATE	[SU][계약] 수수료 건별 유지자료
SU_ETC_CASE_PRODUCTIVITY_MONTH	[SU][수수료]건별 생산성수수료
SU_EMP_EVALUATION_MONTH	[SU][수수료]인별 평가성적
SU_CNT_JIGUB_RATE_MONTH	[SU][수수료]회차별 지급율
TBSY_PKG_EXEC_LOG_MONTH	[SY][시스템] 패키지-프로시저 실행 로그
SU_REC_JIGUB_PROCESS_MONTH	[SU][지급] 리크루팅 지급수수료 증권번호별
SU_SCD_MONTH	[SU][수수료] 수수료 조직마감관리
SU_USI_SCD_MONTH	[SU][수수료]조직별 유지율
SU_SCD_INSCO_PROCESS_MONTH	[TEMP][수수료] 조직별-보험사별 지급수수료
SU_SCD_PATH_VIEW_MONTH	[SU][수수료] 수수료 조직 보기 설정
SU_SUIP_DATA_MONTH	[SU][수수료]수입수수료 업로드 데이터
SU_SUGUM_SCD_MONTH	[SU][수수료]조직별 수금율
SU_OTHER_FEES_MONTH	[SU][수수료] 기타지급 및 공제
SU_SUIP_STD_RULE_MONTH	[SU][수수료]월별 표준데이터 마스터 규정관리
SU_HWANSU_EMP_MONTH	
SU_OVR_JIGUB_PROCESS_MONTH	[SU][지급] 오버라이드 증권번호별
SU_JIGUB_TRANSFER_MONTH	[수수료]이관계약수수료
SU_SCD_OVR_DEFAULT_MONTH	[SU][수수료] 조직별 오버라이드 기본값 설정 테이블
SU_SEIZE_TARGET_EMP_MONTH	[SU][수수료] 수수료압류대상자
SU_SUIP_CONT_JIGUB_LOGIC_CONF	[SU][수수료] 수입수수료 지급로직 설정
TBSY_TOKEN_HIST	API CONNECTOR 토큰 관리
TBSY_PROCEDURE_MANAGE_MST	[SY][시스템]패키지 OR 프로시저 관리
TBSY_UPLOAD_MAP_ERRCODE_MST	[SY][시스템] 맵핑 에러 데이터 코드 관리
SU_JIGUB_CALC_RULE_MONTH	
SU_FC_CONTRACT_MST_MONTH	[SU][수수료]FC 계약마스터
SU_EMP_POLICY_MONTH	[SU][수수료] 시책(인별)
SU_CONTRACT_SHARE_MONTH	[SU][계약] 계약쉐어관리
SU_GUARANTEE_EMP_MONTH	[SU][수수료] 보증보험관리
SU_PAYROLL_OPEN_MONTH	
SU_CAR_JIGUB_PROCESS_MONTH	[SU][지급] 자동차 증권번호별
SU_SUIP_STAT_RULE_MONTH	[SU][수수료]월별 수입수수료 명세서 계산 마스터 규정관리
SU_JIGUB_CAR_CALC_RULE_MONTH	[SU][수수료] FC 자동차 수수료 설정 규정관리
SU_SUIP_STAT_AMT_MONTH	[SU][수수료]월별 수입수수료 명세서 금액 데이터
SU_EMP_JIGUB_SETTLEMENT	
SU_JIGUB_GEN_CALC_MST_MONTH	FC 일반 수수료(지급수수료) 설정
SU_IS_RATE_EMP_MONTH	[수수료]인별 불완전판매율 관리
SU_POK_NAFYC_MONTH	[SU][POK] 푸르덴셜 NAFYC 건별
SU_POK_CASE_DETAIL_MONTH	[SU][POK] 푸르덴셜 계약관리 커미션
SU_POK_ETC_DETAIL_MONTH	[SU][POK] 푸르덴셜 기타 수당
SU_POK_PNP_MONTH	[SU][POK] 푸르덴셜 PNP 상세
계약마스터_상품계약자피보험	
SU_POK_EMP_PAYROLL_MONTH	[SU][POK] 푸르덴셜 인별 수수료
SU_SUIP_COM_RULE_MONTH_TEMP	
SU_POK_ALWNC_ITM_CD	[SU][POK] 푸르덴셜 수당항목코드
SU_POK_EMP_ALWNC_VALUE	[SU][POK] 푸르덴셜 수당항목
SU_POK_CASE_AGCS_USI	[SU][POK] 푸르덴셜 건별 LP AGCS 유지 자료
SU_POK_LP_CASE_MONTH	[SU][POK] 푸르덴셜 LP 건별 수수료
SU_POK_SM_CASE_MONTH	[SU][POK] 푸르덴셜 SP 건별 오버라이드
SU_POK_AM_CASE_MONTH	[SU][POK] 푸르덴셜 AM 건별 오버라이드
TB_ALW_ALWNC_HIS_MIG_20230619	
TB_ALW_ALWNC_ROLLUP_HIS_MIG_20230620	
SU_EMP_JIGUB_PAYROLL_MONTH	[SU][수수료] 인별 지급수수료 명세서 테이블
SU_POK_SETTLEMENT_MONTH	[SU][POK] 푸르덴셜 정착지원금 상세
SU_POK_SM_RNR_MONTH	[SU][POK] 푸르덴셜 SM 신규위촉 및 정착 보너스
SU_POK_AM_RNR_MONTH	[SU][POK] 푸르덴셜 AM 신규위촉 및 정착 보너스
SU_POK_PNG_MONTH	[SU][POK] 푸르덴셜 생산성 향상 및 성장 보너스 상세
SU_POK_CASE_SM_AGCS_USI	[SU][POK] 푸르덴셜 건별 SM AGCS 유지 자료
SU_POK_CASE_AM_AGCS_USI	[SU][POK] 푸르덴셜 건별 AM AGCS 유지 자료
이월환수강제반영	
SU_EMP_JIGUB_PAYROLL_MONTH_220921	
SU_FC_CONTRACT_MST_MONTH_MIG0922	
SU_EMP_JIGUB_PAYROLL_MONTH_220923	
SU_FC_CONTRACT_MST_MONTH0825	
SU_CONTRACT_MONTH_TEMP	
SU_EMP_JIGUB_PAYROLL_MONTH_20221215	
CARRIED_RETURN_AMT_2215_삭제금지	
SU_EMP_JIGUB_PAYROLL_MONTH_20221212	
SU_POK_DIRECTOR_OVR_BASE_MONTH	[SU][POK] 사업본부장 수당 계산 기초데이터 
SU_POK_DUTY_MONTH	
SU_POK_PNP_EX_MONTH	[SU][POK] 푸르덴셜 PNP 성립 외 상세
SU_SL_SELECTED_BONUS_MONTH	[SU][수수료] 월별 SL 선발보너스
SU_SL_OUTCOME_BONUS_MONTH	[SU][수수료] 월별 SL 성과보너스
SU_SL_OUTCOME_BONUS_CASE_MONTH	[SU][수수료] SL 성과보너스1 건별 결과 테이블
SU_POK_SL_OUTCOME_BONUS_CASE_ALWNC_VALUE	[SU][POK] 푸르덴셜 SL성과보너스1 건별 수당항목코드
SU_POK_SL_CASE_MONTH	[SU][POK] 푸르덴셜 SL 건별 수수료
SU_FC_CONTRACT_MST_MONTH221020	
SU_EMP_JIGUB_SCOT_MONTH	
SHEDLOCK	스케줄잠금
FC마스터_에이전시마이그	
SU_EMP_STAT_INFO_MONTH_BACK_230523	
SU_EMP_STAT_INFO_MONTH_MIG	
SU_DIRECTOR_OVR_PROCESS_MONTH	[SU][수수료] 월별 사업본부장 오버라이드
SU_DIRECTOR_ACTI_BONUS_EMP_MONTH	[SU][수수료] ACTIVATION 보너스 인별
SU_DIRECTOR_ACTI_BONUS_SCD_MONTH	[SU][수수료] ACTICATION BONUS 조직별
SU_EMP_STAT_INFO_MONTH	[SU][수수료] 인사마감관리
SU_POK_DUTY_MONTH_MIG_20230615	
SU_POK_EMP_DUTY_ALWNC_VALUE	[SU][POK] 푸르덴셜 책임분담금 수당항목 (L0400522, L0400524)
SU_POK_DUTY_MONTH_BY_ROLLUP_HIS	[SU][POK] 월별 SM/AM 책임분담금 상세
CONTRACT_MST_MIG	
SU_POK_ETC_DETAIL_MONTH_MIG2	
SU_DIRECTOR_AGENCY_MONTH	[SU][수수료] AM규모수당
SU_EMP_LP_SETTLEMENT_MONTH	[SU][수수료] 보증보험관리
SU_POK_SMOVR_CASE_MONTH	[SU][POK] 푸르덴셜 SM 오버라이드(성립) 상세
SU_POK_AMOVR_CASE_MONTH	[SU][POK] 푸르덴셜 AM 오버라이드(성립) 상세
TB_ALW_ALWNC_HIS_MIG_20230524	
SU_FC_CONTRACT_MST_MONTH_MIG2	
SU_TARGET_SL_MONTH	[SU][수수료] 월별 SL대상자 및 SL유치자 정보
SU_SL_OVR_STANDARD_DATA_MONTH	[SU][수수료] SL 오버라이드 계산마스터(지급표준 - 장기, 일시납)
SU_SL_OVR_JIGUB_PROCESS_MONTH	[SU][지급] SL 오버라이드 증권번호별
SU_PROMOTION_DETAIL_MONTH	[SU][수수료] PROMOTION 건별 상세
TB_HRM_HR_DTL	
SU_POK_LP_CASE_MONTH_230626_202305	
SU_POK_SM_CASE_MONTH_230626_202305	
SU_POK_AM_CASE_MONTH_230626_202305	
SU_JIKGUB_GUARANTEE_RATE_MONTH	
SU_OVR_JIGUB_PROCESS_MONTH_MIG	
SU_OVR_JIGUB_PROCESS_MONTH_0919	
SU_EMP_EXCEPT_CODE	
SU_EMP_MONTH	[SU][수수료] 인사마감관리
SU_FC_JIGUB_PROCESS_MONTH_0919	
SU_CONTRACT_ADD_RATE_MONTH	[SU][수수료] 증번별 가산율 - 수기업로드용
SU_POK_ETC_DETAIL_MONTH_MIG	
SU_FC_CONTRACT_MST_MONTH_MIG_CHANNEL	
TEMP_EMP_JIGUB_PAYROLL_MONTH	[TEMP][수수료] 인별 지급수수료 명세서 전역 임시테이블 - SU_EMP_JIGUB_PAYROLL_MONTH 구조가 동일해아함
TEMP_SL_OVR_CALC_MONTH	[TEMP][임시테이블] SL 오버라이드 계산 임시테이블
TEMP_SUIP_STAT_AMT_SCD_MONTH	
TEMP_SUIP_STAT_AMT_MONTH	
TEMP_SUIP_AMT_MONTH	
TEMP_SUIP_STANDARD_DATA_MONTH	[TEMP][SU] 수입수수료 표준데이터 전역 임시테이블 - SU_SUIP_STANDARD_DATA_MONTH와 구조가 동일해야함
TEMP_REC_CALC_MONTH	[TEMP][임시테이블] 리크루팅 계산 임시테이블
TEMP_SCD_PAYROLL_SUJI_MONTH	[TEMP][수수료] 조직별 명세항목별 수입 대비 지급 전역 임시테이블 - SU_SCD_PAYROLL_SUJI_MONTH 테이블과 구조가 동일해아함
TEMP_SCD_INSCO_PROCESS_MONTH	[TEMP][수수료] 조직별-보험사별 지급수수료 전역 임시테이블 - SU_SCD_INSCO_PROCESS_MONTH 테이블과 구조가 동일해아함
TEMP_OVR_CALC_MONTH	[TEMP][임시테이블] 오버라이드 계산 임시테이블
TEMP_FC_JIGUB_CALC_MONTH	[TEMP][임시테이블] 지급수수료 계산 임시테이블
TOAD_PLAN_TABLE	
SU_FC_STANDARD_DATA_MONTH	[SU][수수료] FC계산마스터(지급표준 - 장기)
FC마스터_교차판매마이그	
SU_MIN_PRFM_CLOS_MONTH	[ERP]월별 최저실적 달성 정보
SU_CONTRACT_ADD_RATE_MIG	
SU_FC_CONTRACT_MST_MONTH_230532	
SU_FC_CONTRACT_MST_MONTH_MIG	
PKG_CM_UTIL.PKG_EXEC_LOGGING	
PKG_CM_UTIL.CREATE_MEMBER_RESOURCES	
PKG_CM_UTIL.EXCEL_UPLOAD_ERROR_CHK	
PKG_CM_UTIL.EXCEL_UPLOAD_SAVE_DATA	
PKG_POK_CALC.PRC_POK_COMM_CREATE	
PKG_POK_CALC.PRC_POK_PAYROLL_CREATE	
PKG_SU_CALC.FN_GET_CNT_JIGUB_RATE	
PKG_SU_CALC.FN_GET_CNT_JIGUB_RATE_TYPE2	
PKG_SU_CALC.FN_GET_CNT_HWANSU_RATE	
PKG_SU_CALC.PRC_ST010_CREATEMONTH	
PKG_SU_CALC.PRC_ST020_COPYMONTH	
PKG_SU_CALC.PRC_ST100_CALC_SUIP	
PKG_SU_CALC.PRC_ST110_CALC_SUIP_STAT	
PKG_SU_CALC.PRC_ST120_CALC_SUIP_STD	
PKG_SU_CALC.PRC_ST130_STND_NEWCONT_MATCH	
PKG_SU_CALC.PRC_ST140_STND_REDUCE_MATCH	
PKG_SU_CALC.PRC_ST200_CALC_CASE_EVALUATION	
PKG_SU_CALC.PRC_ST210_CALC_EMP_EVALUATION	
PKG_SU_CALC.PRC_ST220_CALC_ORG_EVALUATION	
PKG_SU_CALC.PRC_ST230_CALC_COMM_EMP_USI	
PKG_SU_CALC.PRC_ST230_CALC_COMM_ORG_USI	
PKG_SU_CALC.PRC_ST300_CRE_FC_CONTRACT_MST	
PKG_SU_CALC.PRC_ST310_CRE_OVR_CONTRACT_MST	
PKG_SU_CALC.PRC_ST320_CRE_FC_CALC_MST	
PKG_SU_CALC.PRC_ST330_CRE_REC_CALC_MST	
PKG_SU_CALC.PRC_ST340_CRE_OVR_CALC_MST	
PKG_SU_CALC.PRC_ST400_CALC_JIGUB	
PKG_SU_CALC.PRC_ST410_CALC_JIGUB_FC_HW	
PKG_SU_CALC.PRC_ST410_CALC_JIGUB_FC_BI	
PKG_SU_CALC.PRC_ST420_CALC_RSGN_PROCESS	
PKG_SU_CALC.PRC_ST420_CALC_JIGUB_PROCESS	
PKG_SU_CALC.PRC_ST420_CALC_CAR_PROCESS	
PKG_SU_CALC.PRC_ST420_CALC_GEN_PROCESS	
PKG_SU_CALC.PRC_ST430_CALC_JIGUB_REC_HW	
PKG_SU_CALC.PRC_ST440_CALC_REC_PROCESS	
PKG_SU_CALC.PRC_ST450_CALC_JIGUB_OVR_HW	
PKG_SU_CALC.PRC_ST450_CALC_JIGUB_OVR_BI	
PKG_SU_CALC.PRC_ST460_CALC_OVR_PROCESS	
PKG_SU_CALC.PRC_ST470_CALC_ETC_LP_SETTLE	
PKG_SU_CALC.PRC_ST470_CALC_ETC_AM_JIGUB	
PKG_SU_CALC.PRC_ST500_CALC_JIGUB_PAYROLL	
PKG_SU_CALC.PRC_ST500_CALC_SCOT_PROCESS	
PKG_SU_CALC.PRC_ST501_CALC_SAVING_PROCESS	
PKG_SU_CALC.PRC_ST502_CALC_DIRECTOR_PROCESS	
PKG_SU_CALC.PRC_ST500_CRE_SL_OVR_CALC_MST	
PKG_SU_CALC.PRC_ST500_OVR_SL_CD_HW	
PKG_SU_CALC.PRC_ST500_OVR_SL_CD_BI	
PKG_SU_CALC.PRC_ST510_CALC_SL_OVR_PROCESS	
PKG_SU_CALC.PRC_ST520_CALC_SL_OVR_PROCESS	
PKG_SU_CALC.PRC_ST510_CALC_JIGUB_STAT	
PKG_SU_UTIL.GET_COMMCD_NM	
PKG_SU_UTIL.IS_DATE	
PKG_SU_UTIL.IS_NUMBER	
PKG_SU_UTIL.CREATE_MONTH_PATITION	
PKG_SU_UTIL.GATHER_TABLE_STATS	